############
#          #
#  P  O    #
#      X   #
#          #
############
