############################################################################################################
#                                                                                                          #
#                                                                                                          #
#                                                                                                          #
#                                                                                                          #
#                                                                                                          #
#                                                                                                          #
#                                                                                                          #
#                                                                                                          #
#                                                                                                          #
#                                                                                                          #
#                                                                                                          #
#                                                                                                          #
#                                                                                                          #
#                                                                                                          #
#                                                                                                          #
#                                                                                                          #
#                                                                                                          #
#                                                                                                          #
#                                                                                                          #
#                                                                                                          #
#                                                                                                          #
#                                                                                                          #
#                                                                                                          #
#                                                                                                          #
#                                                                                                          #
#                                                                                                          #
#                                                                                                          #
#                                                                                                          #
#                                                                                                          #
#                                                                                                          #
#                                                                                                          #
#                                                                                                          #
#                                                                                                          #
#                                                                                                          #
#                                                                                                          #
#                                                                                                   POX    #
############################################################################################################
